17|83|1950-01-01|2999-12-31
17|68|1950-01-01|2999-12-31
17|69|1950-01-01|2999-12-31
17|82|1950-01-01|2999-12-31
10|100|1950-01-01|2999-12-31
10|98|1950-01-01|2999-12-31
10|97|1950-01-01|2999-12-31
10|99|1950-01-01|2999-12-31
7|71|1950-01-01|2999-12-31
7|84|1950-01-01|2999-12-31
7|70|1950-01-01|2999-12-31
7|85|1950-01-01|2999-12-31
18|93|1950-01-01|2999-12-31
18|94|1950-01-01|2999-12-31
18|95|1950-01-01|2999-12-31
18|96|1950-01-01|2999-12-31
19|24|1950-01-01|2999-12-31
19|25|1950-01-01|2999-12-31
19|52|1950-01-01|2999-12-31
19|51|1950-01-01|2999-12-31
1|18|1950-01-01|2999-12-31
1|19|1950-01-01|2999-12-31
1|50|1950-01-01|2999-12-31
1|49|1950-01-01|2999-12-31
4|40|1950-01-01|2999-12-31
4|58|1950-01-01|2999-12-31
4|41|1950-01-01|2999-12-31
4|57|1950-01-01|2999-12-31
16|1000|1950-01-01|2999-12-31
8|65|1950-01-01|2999-12-31
8|80|1950-01-01|2999-12-31
8|81|1950-01-01|2999-12-31
8|64|1950-01-01|2999-12-31
9|79|1950-01-01|2999-12-31
9|78|1950-01-01|2999-12-31
9|63|1950-01-01|2999-12-31
9|62|1950-01-01|2999-12-31
5|53|1950-01-01|2999-12-31
5|28|1950-01-01|2999-12-31
5|29|1950-01-01|2999-12-31
5|54|1950-01-01|2999-12-31
11|27|1950-01-01|2999-12-31
11|26|1950-01-01|2999-12-31
11|55|1950-01-01|2999-12-31
11|56|1950-01-01|2999-12-31
20|87|1950-01-01|2999-12-31
20|86|1950-01-01|2999-12-31
20|73|1950-01-01|2999-12-31
20|72|1950-01-01|2999-12-31
12|42|1950-01-01|2999-12-31
12|92|1950-01-01|2999-12-31
12|91|1950-01-01|2999-12-31
12|90|1950-01-01|2999-12-31
2|22|1950-01-01|2999-12-31
2|21|1950-01-01|2999-12-31
2|20|1950-01-01|2999-12-31
2|23|1950-01-01|2999-12-31
6|108|1950-01-01|2999-12-31
6|105|1950-01-01|2999-12-31
6|106|1950-01-01|2999-12-31
6|107|1950-01-01|2999-12-31
15|109|1950-01-01|2999-12-31
13|60|1950-01-01|2999-12-31
13|61|1950-01-01|2999-12-31
13|77|1950-01-01|2999-12-31
13|76|1950-01-01|2999-12-31
3|103|1950-01-01|2999-12-31
3|104|1950-01-01|2999-12-31
3|101|1950-01-01|2999-12-31
3|102|1950-01-01|2999-12-31
14|88|1950-01-01|2999-12-31
14|89|1950-01-01|2999-12-31
14|75|1950-01-01|2999-12-31
14|74|1950-01-01|2999-12-31
